Add Share=Dodaj udział
All files encrypted=Wszystkie pliki zaszyfrowane
All files protected=Wszystkie pliki chronione
All files unprotected=Wszystkie pliki niechronione
Allocation method=Metoda alokacji
Array must be Started to view Shares=Macierz musi być **uruchomiona** by przeglądać udziały
Automatically split any directory as required=Automatycznie dziel katalogi w razie potrzeby
Automatically split only the top five directory levels as required=Automatycznie dziel tylko pierwsze pięć poziomów katalogów w razie potrzeby
Automatically split only the top four directory levels as required=Automatycznie dziel tylko pierwsze cztery poziomy katalogów w razie potrzeby
Automatically split only the top level directory as required=Automatycznie dziel tylko katalog główny w razie potrzeby
Automatically split only the top three directory levels as required=Automatycznie dziel tylko pierwsze trzy poziomy katalogów w razie potrzeby
Automatically split only the top two directory levels as required=Automatycznie dziel tylko pierwsze dwa poziomy katalogów w razie potrzeby
Comments=Komentarze
Compute All=Oblicz rozmiary
Compute=Oblicz
Disk Shares=Udziały dyskowe
Do not use pool names=Nie używaj nazw pul
Do not use reserved names=Nie używaj zarezerwowanych nazw
Enable Copy-on-write=Włącz kopiowanie przy zapisie
Enter a name for the share=Podaj nazwę udziału
Excluded disks=Wykluczone dyski
Export=Eksportuj
Fill-up=Wypełnij
Free=Wolne
has been deleted=został usunięty
HDD=HDD
High-water=Wysoka woda
Included disks=Uwzględnione dyski
Invalid Characters=Nieprawidłowe znaki
Invalid share name=Nieprawidłowa nazwa udziału
Manual do not automatically split directories=Ręcznie: nie dziel katalogów automatycznie
Minimum free space=Minimalna ilośc wolnego miejsca
Missing share name=Brak nazwy udziału
Most-free=Njawięcej wolnego miejsca
Mover takes no action=Przenośnik nic nie robi
Mover transfers files from array to cache=Przenośnik transferuje pliki z macierzy do pamięci podręcznej
Mover transfers files from cache to array=Przenośnik transferuje pliki z pamięci podręcznej do macierzy
next user share=następny udział użytkownika
Only=Tylko
Prefer=Preferuj
previous user share=poprzedni udział użytkownika
Read=Odczyt
Recompute=Przelicz
Rule=Reguła
Select cache pool=Wybierz pulę pamięci podręcznej
Set when adding new share only=Ustaw tylko gdy dodajesz nowy udział
Share contains data=Udział zawiera dane
Share is empty=Udział jest pusty
Share is outside the list of designated disks=Udział poza listą przeznaczonych dla niego dysków
Share Settings=Ustawienia udziału
Share status=Status udziału
Size=Rozmiar
Some or all files unencrypted=Niektóre lub wszystkie pliki niezaszyfrowane
Some or all files unprotected=Niektóre lub wszystkie pliki niechronione
Split level=Poziom podziału
SSD=SSD
There are no exportable disk shares=Nie ma eksportowalnych udziałów dyskowych
There are no exportable user shares=Nie ma eksportowalnych udziałów użytkowników
Time Machine volume size limit=Limit rozmiaru woluminu Time Machine
Unknown encryption state=Nieznany status szyfrowania
Use cache pool for new filesdirectories=Używaj puli pamięci podręcznej dla nowych plików/katalogów
User Shares=Udziały użytkowników
Write=Zapis
You cannot use the following within share names=Nie możesz użyć następujących znaków w nazwie udziału

; Note: July 9, 2023 - 18 missing translations
Calculated free space value=
Clean Up=
CLEAN UP=
Exclusive access=
Mover action=
Mover transfers files from Primary storage to Secondary storage=
Mover transfers files from Secondary storage to Primary storage=
No unused share configurations present=
Not used=
Primary storage %s=
Primary storage for new files and folders=Primary storage (for new files and folders)
Primary storage to Secondary storage=
Remove unused share configurations=
Removed share configurations=
Secondary storage to Primary storage=
Secondary storage=
Share name contains invalid characters for ZFS use=
Storage=
